  WWWWWWWWWWWWWWWWWWW
  S     W       W   W
W WWWWW WWW W WWWWW W
W W W     W W       W
W W WWWWW WWW WWWWWWW
W                   W
WWW W WWWWW WWW WWWWW
W   W   W   W W     W
W WWWWWWW W W WWWWW W
W W       W W   W W W
W WWWWW WWW W W W W W
W   W     W W W     W
W WWW WWW W WWWWW WWW
W   W W W W W W W   W
WWW WWW W WWW W W WWW
W   W   W   W   W W W
W WWW WWWWWWW W E W W
W W   W     W W   W W
WWW WWWWW WWW W W W W
W             W W   
WWWWWWWWWWWWWWWWWWW 